EEEEEEXXXXEEXXX
XXXXEEXXAXEEXOX
XXBXEEXXXXEEXXX
XXXXEEXXXXEEXXX
XVXXbbXXXXaaXXX
XXXXEEXXXXEEEEE