EEEEETEEE
EEEEXXEEE
XXXXXXtbO
XBEXXXEEE
EEEEXXEEE
EEEEEVEEE