EEEEEFEEE
EEEEXXEEE
XXXXXXfbO
XBEXXXEEE
EEEEXXEEE
EEEEEVEEE