EEEEEEEEEEEXXXX
EXXXXXXXXXXXXVX
EXXXXEEEEEEEXXX
EXXXXEEEEEEEEEE
EXXXXEEEEEEEEEE
EEEXXXXXXXXXXEE
EEEEEEEEEEXXXXX
XXXEEEEEEEXXXXX
XOXXXXXXXXXXXEE
XXXXEEEEEEEEEEE
