EXXXXEEEEEEE
EXOXXEEEEEEE
EXXXEEEEEEEE
EXEEEXXXXXXE
EXEEEXXEEXXE
VXXXXXXEEXXX
EEEEEXEEEEEX
EEEEEXXXXEEX
EEEEEXXXXXXX
EEEEEEEEXXXE
