EVXXXXXX
EEEEXEEX
EEEEXAXX
EEEEXEE^
OaXXXEEE
EaXX<EEE