VXXXEEEEXXXEEEE
XEXXEEEEXXXOEEE
XEXXEXXXXEXXEEE
XXXEXXEEEEEXEEE
XXEEXXEEEEEXXEE
XXXXXXEEEEEXXEE
EEXEEEEEEEEXXEE
EEXEEEEEEEEEXXX
XXXEEEEEEEEEEXX
XXEEXXEEEEEEXXX
XXXEXXEEXEEEXEE
XXXXXXEXXXEEXEE
XXXEEEEXXXEEXXX
XXXEXXXXXXXXXXX
XXXXXXEEEEEEEEE