EEEEEAEEE
EEEEXXEEE
XXXXXXabO
XBEXXXEEE
EEEEXXEEE
EEEEEVEEE