EEEEEEEEXXXXEEE
EEEEEEEEXXXXEEE
XXXEEEEEXEEXXXX
XVXXXXXXXEEEXOX
XXXEEEEXXAEEXXX
XXXEEEEXXXEEXXX
EXXaEEEXEEEEEEE
EEXXXXXXEEEEEEE
