EEEXXXXXXXEEEE
EEEXXXXXXXEEEE
XXXXEEEEEXXXEE
XXXEEEEEEEXXEE
XXXEEEEEEEXXEE
XVXEEXXXXXXXXX
XXXEEXXXXXXXXX
EEEEEXOXEEXXXX
EEEEEXXXEEXXXX