VXXXXXXXXXEE
XXXXXXXXXXEE
XXXXXXXXXXEE
XXXXXXXXXXEE
XXXXXXXXXXEE
XXXXXXXXXXEE
XXXXXXXXXXEE
XXXXXXXXXXEE
XXXXXXXXXXEE
XXXXXXXXXXXO