EEEXXEEE
EEEVXEEE
2EEXXzXO
XEEXXEEE
XEEX1EEE
ZXXXEEEE