aXX2XXEE
aXEXEXE1
aXEXEXXX
OXEAEXXX
EXEEEXEE
EXXXXXEE
EXXXXXEE
EEEVEEEE