XXXEEEEXXX
XXXFFFFXXX
VXTFFFFXXO
XXXFFFFXXX
XXXEEEEXXX