EEEEEXXEXXXEEEE
EEEEEXXXXXXzEEE
XXXEEEXXEXXXXXE
XVXXXXXXXEEXXEE
EEEEEXXEXXEXXXE
EEEEEXXXXXXEXXE
XXXEEXXXXXXEXXX
XOXXXXEXEEXXXEZ
XXXEEXXXEEEXXXX
XXXEEEEEEEEEXXX
