EEEEEXXXXXXEEEE
EEEEEXEEXXXEEEE
EEEEEXEEXXXXXEE
VXXXXXEEEEEXXXX
EEEEXXXEEEEXXOX
EEEEXXXEEEEEXXX
EEEEEEXEEXXEEEE
EEEEEEXXXXXEEEE
EEEEEEXXXXXEEEE
EEEEEEEXXXEEEEE
