EEEEAXVE
EEEEXXXE
EaaXXXXE
EaaEEEEE
XXXEOccc
XXEEXXXX
XBEEEXXX
XXbbbXXC
