2aaOEEXX
EEEEEEAX
ZXXXVXXX
XXEEzEEE
XXEEzEEE
EEEE1EEE