EEEEOEEE
EEEEFEEE
VXXXXXEE
EEEXXAEE
EEEXzEEE
EEEXzEEE
EEEXXaXZ
EEEXXEXX
EEEEEEFF