EEEEEEXXXXXXXEE
XXXXEEXXXEEXXEE
XXXXXXXXXEEXXXX
XVXXEEEEEEEXXOX
XXXXEEEEEEEXXXX
EEEEEEEEEEEEXXX