OXXXE1XXX
XXXXEXXXX
XXXXEXXXX
EXXXEEXXX
EXX2EEXXV