EEEEEEEEXXEEEEE
EEEEEEEXXXEEEEE
XXEEXXXXXXEEEEE
XVXXXXEEXEEEEEE
XXXXEEEEXEEEXXX
EXXEEEEEAXXXXOX
EEXEEEEEBXEEXXX
EEXXXbEEXXEEEEE
EEEXXXEEXXEEEEE
EEEaXXXXXXEEEEE
