XXXEEEEEEE
XVXXXXEEEE
XXXXXXXXXE
EXXXXXXXXX
EEEEEXXOXX
EEEEEEXXXE